{
  "25": 1,
  "26": 2,
  "27": 0,
  "28": 0,
  "29": 1,
  "30": 2
}